(23, 22)
+---+---+---+---+---+---+---+---+---+---+---+---+---+---+---+---+---+---+---+---+---+---+---+---+---+---+---+---+---+---+---+---+---+---+---+---+---+---+---+---+
|               |           |               |       |           |               |           |           |               |           |                           |
+   +---+---+   +   +   +---+   +   +---+   +   +   +   +   +   +   +   +---+---+   +   +---+   +   +   +---+---+---+   +   +   +   +   +   +---+---+---+---+   +
|   |               |   |       |       |       |   |   |   |       |   |           |   |       |   |                   |   |   |       |   |           |   |   |
+   +---+---+---+   +---+   +---+---+   +---+---+---+   +   +---+---+---+   +---+---+   +   +---+   +---+---+---+---+---+   +   +   +---+---+   +---+   +   +   +
|   |           |   |       |           |           |   |       |           |       |       |       |                       |   |   |           |   |   |       |
+   +   +---+   +---+   +---+   +---+   +   +---+   +   +---+   +   +---+---+---+   +---+---+   +   +   +---+---+---+---+---+   +---+   +---+---+   +   +---+   +
|       |       |       |   |   |       |       |   |   |   |       |                   |       |   |                       |           |           |       |   |
+   +---+   +---+   +---+   +   +---+---+---+   +   +   +   +---+---+   +   +---+---+   +   +---+---+   +---+---+---+   +---+---+---+   +   +---+   +---+   +   +
|       |           |       |   |           |   |   |   |           |   |   |   |       |   |           |           |   |           |       |       |   |   |   |
+---+   +---+---+---+---+   +   +   +   +---+   +   +   +   +---+   +   +   +   +   +---+   +   +---+---+   +---+   +---+   +---+   +---+---+   +---+   +   +   +
|       |                   |   |   |       |   |       |       |       |   |   |   |   |       |       |       |   |       |   |   |                   |   |   |
+   +---+---+   +   +   +---+   +   +---+   +   +---+---+---+---+---+---+   +   +   +   +---+---+   +   +---+   +   +   +---+   +   +---+---+   +---+---+   +   +
|   |       |   |   |   |       |   |   |   |                   |       |   |   |       |           |       |   |   |   |       |           |   |           |   |
+   +   +   +---+   +   +   +   +   +   +   +---+---+---+---+   +   +   +   +   +---+   +   +   +---+---+---+   +   +   +---+   +---+---+   +---+   +---+---+   +
|       |           |   |   |   |   |   |   |               |       |       |   |           |   |           |   |       |       |       |       |   |       |   |
+---+---+---+---+---+   +   +---+   +   +   +   +---+   +---+---+---+---+---+   +   +---+---+---+   +---+   +   +---+---+   +---+   +   +---+   +   +---+   +   +
|           |           |           |   |   |   |   |               |               |               |           |           |       |       |   |       |       |
+   +---+   +   +---+---+---+---+---+   +   +   +   +---+---+---+   +   +---+---+---+   +   +---+---+---+---+---+---+   +---+   +---+---+   +   +   +   +---+---+
|   |   |   |                           |   |   |           |   |       |           |   |   |                       |           |       |       |   |           |
+   +   +   +---+---+---+---+---+---+   +   +   +   +   +   +   +---+---+---+   +---+   +   +   +---+---+---+---+   +   +---+---+---+   +---+---+---+---+---+   +
|   |   |   |               |           |       |   |   |       |           |       |   |   |   |               |   |       |                                   |
+   +   +   +   +   +   +---+   +---+---+---+---+---+   +---+   +---+   +   +---+   +   +---+   +---+   +---+   +   +---+   +---+   +---+---+---+---+---+---+   +
|       |       |   |   |       |                   |       |           |   |       |       |       |       |   |       |       |               |           |   |
+---+   +---+---+   +---+   +---+   +   +---+---+   +---+   +---+---+---+   +   +   +---+   +---+   +   +   +   +---+   +---+   +---+   +---+   +   +---+---+   +
|   |   |       |       |       |   |           |       |       |       |       |   |   |       |   |   |   |       |   |           |   |   |   |   |           |
+   +   +   +   +---+   +---+   +   +---+---+   +---+   +---+   +   +---+---+---+   +   +---+   +   +---+   +---+   +   +---+---+   +   +   +   +   +   +---+---+
|   |   |   |       |       |   |   |       |       |   |       |               |   |   |       |           |   |   |       |   |   |       |   |               |
+   +   +---+---+   +   +---+   +   +---+   +---+   +   +   +---+   +---+   +   +   +   +   +   +---+---+---+   +   +---+   +   +   +---+   +   +---+---+---+---+
|       |       |   |   |       |               |   |       |       |   |   |   |       |   |   |               |   |   |   |   |       |   |                   |
+   +---+   +   +   +   +   +---+   +---+---+   +   +---+---+---+   +   +   +---+---+   +   +---+   +   +---+---+   +   +   +   +---+   +---+   +---+---+---+   +
|   |       |       |   |   |       |       |   |               |       |       |       |   |       |       |       |   |   |       |       |               |   |
+   +   +---+---+   +   +   +---+---+   +   +   +---+---+---+   +   +---+---+   +   +---+   +   +---+---+   +   +---+   +   +   +---+---+   +---+---+---+   +   +
|       |           |       |           |   |       |   |       |   |       |       |   |   |   |       |   |   |       |   |       |       |           |   |   |
+---+---+   +---+---+---+---+   +---+---+   +---+   +   +   +---+---+   +   +   +---+   +   +   +   +   +   +   +   +   +   +   +   +   +---+   +---+   +   +   +
|       |   |   |               |       |   |           |   |           |   |           |       |   |       |   |   |   |   |   |       |           |   |   |   |
+   +---+   +   +   +   +---+---+   +   +   +---+---+   +   +   +---+---+   +---+---+---+---+   +   +---+---+   +---+   +   +   +---+---+---+---+   +   +---+   +
|   |       |       |           |   |   |   |       |   |   |   |       |                   |   |               |       |   |                   |   |       |   |
+   +   +---+---+---+---+---+   +   +   +   +   +   +---+   +   +   +---+---+---+---+---+   +   +---+---+---+---+   +   +   +---+---+---+---+   +   +---+   +   +
|   |   |                       |   |   |   |   |           |   |   |               |       |                       |   |       |                   |   |   |   |
+   +   +---+   +---+---+---+---+   +   +   +   +---+---+---+   +   +   +---+---+   +   +---+---+---+---+---+---+---+   +---+   +---+---+---+---+---+   +   +   +
|   |   |       |       |           |       |           |       |           |   |                               |   |   |   |                   |       |       |
+   +   +   +---+---+   +   +---+---+---+---+---+---+   +   +---+---+---+   +   +---+---+---+---+---+---+---+   +   +   +   +---+---+---+---+   +   +---+---+   +
|   |   |   |       |           |                   |   |           |   |       |   |               |   |       |   |   |                   |   |               |
+   +   +   +   +   +---+---+   +---+---+   +---+   +   +---+---+   +   +---+   +   +   +---+---+   +   +   +---+   +   +   +---+---+   +---+   +---+---+---+   +
|       |       |           |           |   |   |   |           |   |               |       |       |       |   |           |       |   |       |           |   |
+   +---+   +---+---+---+   +---+---+   +   +   +   +---+   +   +   +---+---+---+---+---+   +   +---+---+   +   +   +---+---+   +   +---+   +---+   +---+   +---+
|       |   |       |       |       |       |   |           |   |   |                   |   |           |   |       |           |   |       |       |   |       |
+---+   +   +   +   +   +---+---+   +---+---+   +---+---+---+   +   +   +---+---+   +   +---+---+---+   +   +---+---+   +---+---+   +   +   +   +---+   +---+   +
|   |   |   |   |       |               |       |       |       |       |       |   |   |       |       |               |   |       |   |   |       |   |       |
+   +   +---+   +---+---+   +---+---+   +   +   +---+   +   +---+---+---+   +   +   +   +   +   +   +---+---+---+---+---+   +   +---+   +   +---+   +   +   +   +
|       |       |           |               |       |   |   |           |   |   |   |   |   |   |   |   |                   |   |       |       |       |   |   |
+   +---+   +---+   +   +---+---+---+   +---+---+   +   +   +   +---+   +   +---+   +---+   +   +   +   +   +---+---+---+   +   +   +   +---+---+---+   +   +   +
|   |       |       |   |           |   |       |       |       |   |   |       |       |   |   |   |       |           |   |   |   |   |           |   |   |   |
+   +   +---+   +---+---+   +---+   +---+   +   +---+   +---+---+   +   +---+   +---+   +   +   +   +   +---+   +---+   +   +   +---+   +   +   +   +   +   +---+
|       |                   |   |           |   |       |   |       |       |       |   |   |   |   |   |           |   |       |       |   |   |   |   |       |
+---+---+---+---+---+---+   +   +---+---+---+   +   +---+   +   +   +---+   +   +   +   +   +   +   +   +---+---+   +   +---+---+   +   +   +   +---+   +---+   +
|               |       |           |       |   |       |   |   |       |   |   |   |   |   |       |   |       |   |           |   |   |   |       |       |   |
+   +---+---+   +   +   +---+---+---+   +   +   +---+   +   +   +   +---+   +   +---+   +   +---+---+   +   +   +---+   +   +   +   +---+   +---+   +   +---+   +
|           |   |   |                   |   |       |       |   |       |   |       |   |   |       |       |       |   |   |   |               |       |       |
+   +---+   +   +   +   +---+---+---+---+   +---+   +---+   +   +---+   +   +---+   +   +   +   +   +---+---+---+   +   +   +   +---+---+   +---+---+---+   +   +
|       |   |   |   |   |       |       |           |       |       |       |       |       |   |       |       |   |   |   |           |   |               |   |
+---+   +   +   +   +   +   +   +   +   +---+---+---+   +---+---+   +---+---+   +---+---+---+   +---+   +   +---+   +   +   +---+---+   +---+   +---+---+---+   +
|       |   |       |   |   |   |   |               |           |       |                       |   |   |       |   |   |           |           |   |           |
+   +---+   +---+---+---+   +   +---+---+   +   +---+---+   +---+---+   +   +---+---+---+   +---+   +   +---+   +   +---+   +---+   +---+---+---+   +   +---+---+
|       |   |               |           |   |               |           |   |           |       |   |   |       |       |       |   |           |           |   |
+---+   +   +   +---+---+---+---+---+   +---+   +---+---+---+   +---+---+---+   +---+   +---+   +   +   +   +---+---+   +---+   +   +   +---+   +---+---+   +   +
|   |   |       |                   |       |       |       |           |       |               |   |   |           |       |   |       |   |       |   |   |   |
+   +   +---+---+---+---+---+   +---+---+   +---+   +   +---+---+---+   +   +---+---+---+---+---+   +   +   +---+   +---+   +   +---+---+   +---+   +   +   +   +
|       |       |           |   |           |       |           |       |   |       |       |       |   |   |           |   |   |           |       |   |       |
+   +---+   +   +   +---+   +   +   +---+---+   +---+---+---+   +   +---+   +   +   +   +   +   +   +   +---+   +---+   +   +   +   +---+---+   +---+   +---+   +
|           |       |   |       |   |           |       |       |   |   |       |   |   |   |   |               |       |   |   |           |       |       |   |
+---+---+---+---+---+   +---+   +   +   +---+---+   +   +   +   +   +   +   +---+   +   +   +---+---+   +---+---+---+---+   +   +---+---+   +---+   +   +---+   +
|           |           |       |   |   |           |       |   |   |           |       |   |       |   |               |   |   |               |   |       |   |
+---+   +   +---+   +   +   +---+   +   +   +---+---+   +---+---+   +---+---+---+   +---+   +   +   +   +   +---+---+   +   +   +   +   +---+---+   +   +   +   +
|       |   |       |   |   |   |   |       |       |   |           |           |       |       |   |   |   |           |   |       |   |           |   |   |   |
+   +---+   +   +   +---+   +   +   +---+---+   +   +---+   +---+---+   +---+   +---+---+---+---+   +---+   +   +---+   +   +---+   +---+   +---+---+   +   +   +
|       |       |   |       |   |   |           |       |   |               |   |               |           |   |   |   |       |   |       |       |   |   |   |
+   +   +---+---+---+   +---+   +   +   +---+---+---+   +   +---+---+---+   +   +   +---+---+   +---+---+---+   +   +   +---+   +---+   +---+   +---+   +   +   +
|   |                           |                   |                       |       |                           |           |           |               |       |
+---+---+---+---+---+---+---+---+---+---+---+---+---+---+---+---+---+---+---+---+---+---+---+---+---+---+---+---+---+---+---+---+---+---+---+---+---+---+---+---+
